10 10
100 600
154 154 154 154 154 154 154 154 154 154
154 154 154 154 154 154 154 154 154 154
155 155 155 28 157 157 30 155 155 155
155 155 155 28 29 29 30 155 155 155
155 155 155 61 61 61 61 155 155 155
155 155 155 155 157 157 155 155 155 155
155 155 155 155 157 157 155 155 155 155
155 155 155 155 157 157 155 155 155 155
155 155 155 155 157 157 155 155 155 155
155 155 155 155 155 155 155 155 155 155
